11111111
1P00C001
10011C01
1C011001
100C00E1
11111111
