1111111111111
1P000000010C1
1001111001001
E001111001001
1000C000000C1
10C0000C00001
1111111111111