11111111
00000E00
000P0C00
11111111