11111111111111111
1P1CCCCCCCCCCCCC1
101111111CC1CCCC1
1CCCCE1CCCC1111C1
11C111111CC1CCCC1
1CC11CCC1CC111111
1CC1CCCCCCCC10001
1CCCC11C1C111C1C1
1CC11CCC1CCCCC1C1
11111111111111111
