111111111111111
1P00C0000000001
100001100C01001
10000E000001001
10C000000C01CC1
111111111111111
