1111111111111111111
100000001111111E111
1P1000C001C10000001
1011110001010000001
10100C1001010011101
1000C11000000111C01
1111111111111111111
